17 17 17 17 17 17 17 17 17 17 17 17 17 17 17 17 17 17 17 17 17 17 17 17 17 17 17 17 17 17 17 17 17 17 17 17 17 17 17 17 17 17 17 17 17 17 17 17 17 17 17 17 17 17 17 17 17 17 17 17 17 17 17 17 17 17 17 17 17 17 17 17 17 17 17 17 17 17 17 17 17 17 17 17 17 17 17 17 17 17 17 17 17 17 17 17 17 17 17 17 
17 17 17 17 17 17 17 17 17 17 17 17 17 17 17 17 17 17 17 17 17 17 17 17 17 17 17 17 17 17 17 17 17 17 17 17 17 17 17 17 17 17 17 17 17 17 17 17 17 17 17 17 17 17 17 17 17 17 17 17 17 17 17 17 17 17 17 17 17 17 17 17 17 17 17 17 17 17 17 17 17 17 17 17 17 17 17 17 17 17 17 17 17 17 17 17 17 17 17 17 
17 17 17 17 17 17 17 17 17 17 17 17 17 17 17 17 17 17 17 17 17 17 17 17 17 17 17 17 17 10 17 17 17 17 17 17 17 17 17 17 23 17 17 17 17 17 17 17 17 17 17 17 17 17 17 10 17 17 17 17 17 17 17 17 17 17 17 17 17 17 17 17 17 17 17 17 17 17 17 17 17 17 17 17 17 17 17 17 17 17 17 17 17 17 17 17 17 17 17 17 
17 17 17 17 17 17 17 17 17 17 17 17 17 17 17 17 17 17 17 17 17 17 17 17 17 17 17 17 17 17 17 17 17 17 17 17 17 17 17 17 17 17 17 17 17 17 17 23 17 17 17 17 17 17 17 17 17 17 17 17 17 17 17 17 17 17 17 17 17 17 17 17 23 17 17 17 17 17 10 17 17 17 17 17 17 17 17 17 17 17 17 17 17 17 17 17 17 17 17 17 
17 17 17 17 17 17 17 17 17 17 17 17 17 17 17 17 17 17 17 17 10 17 17 17 17 17 17 17 17 17 17 17 17 17 17 17 17 17 17 17 17 17 17 17 17 17 17 17 17 17 17 17 17 17 17 17 17 17 17 17 17 17 17 17 17 17 17 17 17 17 17 17 17 17 17 17 17 17 17 17 17 17 17 17 17 17 23 17 17 17 17 17 17 17 17 17 17 17 17 17 
17 17 17 17 17 17 17 17 17 17 17 17 17 17 17 17 17 17 17 17 17 17 17 17 17 17 17 17 17 17 17 17 17 17 17 17 17 17 17 17 17 17 17 17 17 17 17 17 17 17 17 17 17 17 17 17 17 17 17 17 10 17 17 17 17 17 17 17 17 17 17 17 17 17 17 17 17 17 17 17 17 17 17 17 17 17 17 17 17 17 17 17 17 17 17 17 17 17 17 17 
17 17 17 17 17 17 17 17 17 17 17 17 17 17 23 17 17 17 17 17 17 17 17 17 17 17 17 17 17 17 17 23 17 17 17 17 17 17 17 17 17 17 17 17 17 17 17 17 17 17 17 17 17 17 17 17 17 23 17 17 17 17 17 17 17 17 17 17 17 17 17 17 17 17 17 17 17 17 17 17 17 17 17 17 17 17 17 17 17 17 17 17 17 17 17 17 17 17 17 17 
17 17 17 17 17 17 17 17 17 17 17 17 17 17 17 17 17 17 17 22 22 22 22 22 22 22 22 22 22 22 22 22 22 22 22 22 22 22 22 22 22 22 22 22 22 22 22 22 22 22 22 22 22 22 22 22 22 22 22 22 22 22 22 22 22 22 22 22 22 22 22 22 22 22 22 22 22 22 22 22 22 22 22 17 17 17 17 17 17 17 17 17 17 17 17 17 17 17 17 17 
17 17 17 17 17 17 17 17 17 17 17 17 17 17 17 17 17 17 25 3 3 3 3 3 3 3 3 3 3 3 3 3 3 6 3 3 13 3 3 3 3 3 3 3 3 3 3 3 3 3 3 3 3 3 3 3 3 3 3 3 3 3 3 3 15 15 15 15 15 15 15 15 15 15 15 3 3 3 3 3 13 3 3 24 17 17 17 17 17 17 10 17 17 17 17 17 17 17 17 17 
17 17 17 17 17 17 17 17 17 17 17 17 17 17 17 17 17 17 25 3 3 3 3 6 3 3 3 13 3 3 3 3 3 3 3 3 3 3 3 3 3 6 3 3 3 6 3 3 3 3 3 3 3 3 13 3 3 3 6 3 13 3 3 15 1 1 1 1 1 1 1 1 15 1 1 15 3 13 3 3 3 3 3 24 17 17 17 17 17 17 17 17 17 17 17 17 17 17 17 17 
17 17 17 17 17 17 17 17 17 17 17 17 17 17 17 17 17 17 25 3 3 3 3 3 3 3 3 3 6 3 3 3 3 3 3 3 3 6 3 3 3 3 13 3 3 3 3 3 3 6 3 13 3 3 3 3 3 3 3 3 3 3 15 1 1 1 1 1 1 1 12 1 15 1 1 1 15 3 3 6 3 13 3 24 17 17 17 17 17 17 17 17 17 17 17 17 17 17 17 17 
17 17 17 17 17 17 17 17 17 17 17 17 17 17 23 17 17 17 25 3 3 3 3 13 3 3 3 3 3 3 3 3 13 3 3 3 3 3 3 3 3 3 3 3 3 3 3 3 3 3 3 3 3 3 3 3 3 3 3 3 3 3 15 1 1 1 1 1 1 1 1 1 15 1 1 1 1 15 3 3 13 3 3 24 17 17 17 17 17 17 17 17 17 17 17 17 17 17 17 17 
17 17 17 17 17 17 10 17 17 17 17 17 17 17 17 17 17 17 25 3 3 6 3 3 3 5 3 3 3 3 5 3 3 3 3 3 3 5 3 3 3 3 3 3 3 3 5 3 5 3 5 3 3 3 5 3 5 3 3 5 3 3 15 1 1 1 1 1 1 1 1 1 15 1 1 1 1 1 15 3 3 3 3 24 17 17 17 17 17 17 17 17 17 17 17 17 17 17 17 17 
17 17 17 17 17 17 17 17 17 17 17 17 17 17 17 17 17 17 25 3 3 3 3 3 3 3 3 3 3 3 3 3 3 3 3 3 3 3 3 3 5 3 3 3 5 3 3 3 3 3 3 3 5 3 5 3 5 3 5 3 5 5 1 1 1 1 1 1 1 1 1 1 1 1 1 1 1 1 15 3 3 13 3 24 17 17 17 17 17 17 17 17 17 17 17 17 17 17 17 17 
17 17 17 17 17 17 17 17 17 17 17 17 17 17 17 17 17 17 25 3 3 3 5 3 3 3 5 3 3 5 3 5 3 3 5 3 3 3 3 3 3 3 5 3 3 3 3 5 3 5 3 3 3 3 5 3 3 3 3 3 3 3 15 1 1 1 1 1 1 1 1 1 15 1 1 1 1 15 3 3 13 3 3 24 17 17 17 17 17 17 17 17 17 17 17 17 17 17 17 17 
17 17 17 17 17 17 17 17 17 17 17 17 17 17 17 17 17 17 25 3 3 3 3 3 3 3 5 3 3 3 3 3 3 3 3 3 5 3 5 3 5 3 3 3 5 3 5 3 3 3 5 3 3 3 3 3 3 5 3 3 5 3 15 1 1 1 1 1 1 1 1 1 15 1 1 1 15 3 3 3 3 3 13 24 17 17 17 17 23 17 17 17 17 17 17 17 17 17 17 17 
17 17 17 17 17 17 17 17 17 17 17 17 17 17 17 17 17 17 25 3 6 3 3 3 5 3 3 3 3 3 3 3 3 3 3 5 3 3 3 3 3 3 3 3 3 3 3 3 3 3 3 3 3 3 3 3 3 3 3 3 3 3 3 15 1 1 1 1 1 1 1 1 15 1 1 15 3 3 6 3 3 3 3 24 17 17 17 17 17 17 17 17 17 17 17 17 17 17 17 17 
17 17 17 17 17 17 17 17 17 17 17 17 17 17 17 17 17 17 25 3 3 3 3 3 3 3 5 3 3 3 5 3 6 3 3 3 3 3 3 3 3 3 3 3 3 3 6 3 3 3 3 3 3 3 3 3 3 3 3 3 3 3 3 3 15 15 15 15 15 15 15 15 15 15 15 3 3 3 3 3 3 6 3 24 17 17 17 17 17 17 17 17 10 17 17 17 17 17 17 17 
17 17 17 17 17 17 17 17 17 17 17 17 17 17 10 17 17 17 25 3 3 3 5 3 3 3 5 3 3 3 3 3 3 3 3 3 3 3 3 3 3 3 3 3 3 3 3 3 3 3 3 3 3 3 3 6 3 3 3 3 13 3 3 3 3 3 3 3 3 3 13 3 3 3 3 3 13 3 3 3 3 3 3 24 17 17 17 17 17 17 17 17 17 17 17 17 17 17 17 17 
17 17 17 17 17 17 17 17 17 17 17 17 17 17 17 17 17 17 25 3 3 3 13 3 3 3 3 13 3 3 3 3 3 3 3 3 3 3 3 3 13 3 3 6 3 3 3 3 13 3 3 3 13 3 3 3 3 3 3 3 3 3 3 3 3 13 3 3 3 3 3 3 3 3 3 3 3 13 3 3 13 3 3 24 17 17 17 17 17 17 17 17 17 17 17 17 17 17 17 17 
17 17 17 17 17 17 17 17 17 17 17 17 17 17 17 17 17 17 25 3 3 3 3 3 3 3 3 3 3 3 3 3 3 3 13 3 3 3 6 3 3 3 3 3 3 3 3 6 3 3 13 3 3 3 3 3 3 6 3 3 3 13 3 3 3 3 6 3 3 3 3 3 13 3 6 3 3 3 6 3 3 3 3 24 17 17 17 10 17 17 17 17 17 17 17 17 17 17 17 17 
17 17 17 17 17 17 17 17 17 17 17 17 17 17 17 17 17 17 25 3 13 3 3 3 3 3 3 3 3 3 3 3 3 3 3 3 3 3 3 3 3 6 3 13 3 3 3 3 3 3 3 3 3 3 3 3 13 3 3 3 3 3 3 13 3 3 3 3 3 3 3 13 3 3 3 3 3 3 3 3 3 3 3 24 17 17 17 17 17 17 17 17 17 17 17 17 17 17 17 17 
17 17 17 17 17 17 17 17 17 17 17 17 17 17 17 17 17 17 25 3 3 3 3 3 3 3 3 3 3 3 3 3 3 3 3 3 3 3 3 3 3 3 3 3 3 3 3 3 3 13 3 3 3 13 3 3 3 3 3 3 13 3 13 3 3 3 3 3 13 3 3 3 3 3 3 13 3 3 13 3 3 13 3 24 17 17 17 17 17 17 17 17 23 17 17 17 17 17 17 17 
17 17 17 17 17 17 17 17 17 17 17 17 17 17 17 17 17 17 25 3 3 3 3 3 3 3 3 3 3 3 3 3 13 3 3 13 3 3 6 3 3 3 13 3 3 13 3 3 13 3 3 13 3 13 3 13 3 3 3 3 3 3 3 3 13 3 13 13 3 13 3 13 13 3 13 3 3 3 3 13 3 3 3 24 17 17 17 17 17 17 17 17 17 17 17 17 17 17 17 17 
17 17 17 17 17 23 17 17 17 17 17 17 17 17 17 17 17 17 25 3 3 3 3 3 3 3 3 3 3 3 3 3 3 3 3 13 3 3 3 13 3 3 3 3 3 3 3 3 3 13 3 3 13 3 13 3 13 3 13 3 13 13 13 13 3 13 13 13 3 13 3 13 13 3 3 13 3 3 13 3 3 13 3 24 17 17 17 17 17 17 17 17 17 17 17 17 17 17 17 17 
17 17 17 17 17 17 17 17 17 17 17 17 17 17 17 10 23 17 25 3 3 3 3 3 3 3 3 3 13 3 3 3 3 3 3 3 3 3 13 3 3 3 13 3 3 3 13 3 13 3 13 3 3 13 3 3 3 13 3 3 13 3 3 3 3 3 3 3 3 3 13 3 3 3 13 3 3 13 3 3 3 3 3 24 17 17 17 17 17 17 17 17 17 17 17 17 17 17 17 17 
17 17 17 17 17 17 17 17 17 17 17 17 17 17 17 17 17 17 25 3 3 13 3 3 3 3 3 3 3 3 3 6 3 3 3 13 3 3 3 3 3 3 13 3 3 13 3 13 3 3 3 13 13 3 3 3 13 3 13 13 3 3 3 6 3 3 3 13 3 3 3 3 13 3 3 3 13 3 13 3 3 3 3 24 17 17 17 17 17 17 17 17 17 17 17 17 17 17 17 17 
17 17 17 17 17 17 17 17 17 17 17 17 17 17 17 17 17 17 25 3 3 3 3 3 3 3 3 3 3 3 3 3 3 13 3 3 3 3 13 3 3 13 3 13 3 13 3 3 3 13 13 3 3 13 13 13 3 3 3 3 3 3 3 3 3 3 3 3 3 3 3 3 3 3 3 13 3 3 13 3 13 13 3 24 17 17 17 17 17 17 17 17 17 17 17 17 17 17 17 17 
17 17 17 17 17 17 17 17 17 17 17 17 17 17 17 17 17 17 25 3 3 3 3 3 3 3 3 3 3 3 13 3 3 3 3 3 13 13 3 13 13 3 3 3 13 3 3 3 3 3 3 3 3 3 3 3 3 3 3 3 3 3 3 3 3 3 3 3 3 3 3 3 13 3 3 13 3 13 3 3 3 3 3 24 17 17 17 17 17 23 17 17 17 17 17 17 17 17 17 17 
17 17 17 17 17 17 17 17 17 17 17 17 17 17 17 17 17 17 25 3 3 13 3 3 3 3 3 3 3 3 3 3 3 13 13 13 3 3 3 3 3 3 3 3 3 3 3 3 3 3 3 3 3 3 3 3 3 3 3 3 3 3 3 3 3 3 3 3 3 3 3 3 3 3 3 3 3 3 3 3 3 13 3 24 17 17 17 17 17 17 17 17 17 17 17 17 17 17 17 17 
17 17 17 17 17 17 17 17 17 17 17 17 17 17 17 17 17 17 25 3 3 3 3 3 3 3 3 13 3 3 3 3 3 3 13 3 3 3 3 3 3 3 3 3 3 3 6 3 3 3 3 3 3 3 3 3 3 3 3 3 3 3 3 3 3 3 3 3 3 3 3 3 13 3 13 3 13 3 3 13 3 3 3 24 17 17 17 17 17 17 17 17 17 17 17 17 17 17 17 17 
17 17 17 23 17 17 17 17 17 17 17 22 22 22 22 22 22 22 20 3 3 3 3 3 3 3 3 13 3 3 3 3 13 3 13 3 13 3 3 13 3 3 3 3 3 3 3 3 3 3 3 3 3 3 3 3 3 3 6 3 3 3 3 3 3 3 3 3 3 3 3 3 3 3 3 3 3 3 13 3 13 3 3 24 17 17 17 17 17 17 17 17 17 17 17 17 17 17 17 17 
17 17 17 17 17 17 17 17 17 17 25 3 3 3 3 3 3 3 3 3 3 3 3 3 3 3 3 3 3 6 3 13 3 13 3 3 3 3 3 3 3 3 3 3 3 3 3 3 3 3 3 3 3 3 3 3 3 3 3 3 3 3 3 3 3 3 3 3 3 3 3 13 3 13 3 3 3 3 3 3 3 3 3 24 17 17 17 17 10 17 17 17 17 17 17 17 17 17 17 17 
17 17 17 17 17 17 10 17 17 17 25 3 13 3 3 6 3 3 3 3 3 3 3 3 3 3 3 3 3 3 13 3 3 3 3 3 3 6 5 3 5 3 3 3 3 6 3 3 3 3 3 3 3 3 3 3 3 3 3 3 3 3 3 3 3 6 3 3 3 3 3 3 3 3 3 13 3 13 3 3 3 13 3 24 17 17 17 17 17 17 17 17 17 17 17 17 17 17 17 17 
17 17 17 17 17 17 17 17 17 17 25 3 3 3 3 3 3 3 3 3 3 3 3 3 3 3 13 3 3 3 13 3 3 13 3 3 13 3 3 13 3 3 3 3 3 3 3 3 3 3 3 3 3 3 3 3 3 3 3 3 3 3 3 3 3 3 3 3 3 3 3 13 3 3 3 3 3 3 3 13 3 3 3 24 17 23 17 17 17 17 17 17 17 17 17 17 17 17 17 17 
17 17 17 17 17 17 17 17 17 17 25 3 3 3 3 13 3 3 3 3 3 3 3 3 3 3 3 3 3 3 3 13 3 3 3 3 3 3 13 5 3 5 3 3 3 3 3 3 3 3 3 3 3 3 3 3 3 3 3 3 3 3 3 3 3 3 3 3 3 3 3 3 13 3 3 13 13 3 3 3 3 3 3 24 17 17 17 17 17 17 17 17 17 17 17 17 17 17 17 17 
17 17 17 17 17 17 17 17 17 17 25 3 3 3 3 3 3 3 3 3 3 3 3 3 3 6 3 3 3 3 13 3 3 3 3 13 3 5 3 3 3 3 3 3 3 3 3 3 3 6 3 3 3 3 3 3 3 3 3 3 3 3 3 3 3 3 3 3 3 3 3 13 3 3 3 13 3 13 13 3 3 3 3 24 17 17 17 17 17 17 17 17 10 17 17 17 17 17 17 17 
17 17 17 17 17 17 17 17 23 17 25 3 3 3 13 3 3 3 3 3 3 3 3 3 3 3 3 13 3 13 3 3 3 3 3 3 3 3 13 3 5 3 3 3 3 3 3 3 3 3 3 3 3 3 3 3 3 3 3 3 3 3 3 3 3 3 3 3 13 3 3 3 3 3 13 3 3 13 3 3 13 3 3 24 17 17 17 17 17 17 17 17 17 17 17 17 17 17 17 17 
17 17 17 17 17 17 17 17 17 17 25 3 3 13 3 3 3 3 3 3 3 3 3 3 3 13 3 3 13 3 13 3 3 13 3 6 3 13 3 5 3 3 5 3 3 3 3 3 3 3 3 3 3 3 3 3 3 3 3 3 6 3 3 3 3 3 3 3 3 3 3 3 3 3 3 13 3 3 3 3 3 3 3 24 17 17 17 17 17 17 17 17 17 17 17 17 17 17 17 17 
17 17 17 17 17 17 17 17 17 17 25 3 3 3 3 3 3 3 3 3 3 3 3 3 3 3 3 3 13 3 3 3 3 3 3 3 3 3 5 5 3 3 3 3 3 3 13 3 3 3 3 13 3 3 3 3 3 3 3 3 3 3 3 13 3 3 13 3 3 13 3 3 13 3 3 3 3 13 3 13 3 3 3 24 17 17 17 17 17 17 17 23 17 17 17 17 17 17 17 17 
17 17 17 17 17 17 17 17 17 17 25 3 6 3 3 3 3 13 3 3 3 3 3 3 3 3 3 3 13 3 3 3 3 3 3 3 3 3 5 5 3 3 3 3 3 3 3 3 3 3 3 3 3 3 3 3 3 13 13 3 13 3 3 3 3 3 3 3 3 3 3 3 3 3 13 3 3 13 3 3 3 3 13 24 17 17 17 17 17 17 17 17 17 17 17 17 17 17 17 17 
17 17 17 17 17 17 17 17 17 17 25 3 3 3 13 3 3 3 3 3 3 3 3 3 3 3 3 3 3 13 3 13 3 3 6 3 3 13 5 5 6 3 3 3 3 13 3 3 3 3 13 3 13 3 3 3 3 3 3 3 3 13 13 3 3 3 3 13 3 3 3 13 3 3 3 3 3 3 3 3 3 3 3 24 17 17 17 17 17 17 17 17 17 17 17 17 17 17 17 17 
17 17 17 17 17 17 17 17 17 17 25 3 3 3 3 3 3 3 3 3 3 3 3 3 3 3 13 3 3 13 3 3 3 3 3 13 3 3 5 5 13 3 3 13 3 3 3 3 13 3 3 3 3 3 13 3 3 3 3 3 3 3 3 3 3 13 3 3 3 13 3 3 3 13 3 3 13 3 3 13 3 3 3 24 17 17 17 17 17 17 17 17 17 17 17 17 17 17 17 17 
17 17 17 17 17 17 17 17 17 17 25 3 6 3 3 3 3 3 3 3 3 3 3 3 3 3 13 3 3 3 13 3 3 3 3 3 3 3 5 5 3 3 3 13 3 3 3 3 3 3 3 3 3 3 3 3 3 3 13 3 3 3 3 3 3 13 3 3 3 3 3 3 3 3 13 3 3 3 3 3 3 3 3 24 17 17 17 10 17 17 17 17 17 17 17 17 17 17 17 17 
17 17 17 17 17 17 17 17 17 17 25 3 3 3 3 3 3 3 3 3 3 3 3 3 3 3 13 3 13 3 3 15 15 3 15 15 13 15 5 5 3 13 3 3 3 3 3 3 3 3 3 13 3 3 3 13 3 3 3 3 13 3 3 3 3 3 3 3 3 3 3 13 3 3 3 19 26 26 26 26 26 26 26 17 17 17 17 17 17 17 17 17 17 17 17 17 17 17 17 17 
17 17 17 10 17 17 17 23 17 17 25 3 3 3 3 3 3 3 3 3 3 3 3 3 13 3 3 3 3 3 3 15 1 1 1 1 1 15 5 5 3 3 13 3 3 3 13 3 13 3 3 3 3 3 3 3 3 3 13 3 3 3 3 13 3 3 3 3 13 3 3 3 13 3 3 24 17 17 17 17 17 17 17 17 17 17 23 17 17 17 17 17 17 23 17 17 17 17 17 17 
17 17 17 17 17 17 17 17 17 17 25 3 3 3 3 13 3 3 3 3 3 3 3 3 13 3 3 13 3 3 3 15 1 1 1 6 1 15 5 5 3 3 3 3 3 13 3 3 3 3 6 3 3 3 13 3 3 3 3 13 13 3 3 3 13 3 3 3 13 3 3 3 3 3 3 24 17 17 17 17 17 17 17 17 17 17 17 17 17 17 17 17 17 17 17 17 17 17 17 17 
17 17 17 17 17 17 17 17 17 17 25 3 13 3 3 3 3 3 3 3 3 3 3 3 3 13 3 3 3 13 3 15 1 3 1 1 1 1 5 5 13 3 3 13 13 13 3 3 3 3 3 13 3 3 3 13 3 3 3 3 3 3 3 3 3 3 3 3 3 3 13 3 3 3 3 24 17 17 17 17 17 17 17 17 17 17 17 17 17 17 17 17 17 17 17 17 17 17 17 17 
17 17 17 17 17 17 17 17 17 17 25 3 3 3 3 3 3 3 3 6 3 3 3 3 3 3 13 13 3 3 3 15 1 1 1 1 1 15 5 5 3 3 3 3 3 3 3 13 3 3 3 3 13 3 3 3 3 13 3 3 13 3 13 3 13 3 3 13 3 3 3 3 13 3 3 24 17 17 23 17 17 17 17 17 17 17 10 17 17 17 17 17 17 17 17 17 17 17 17 17 
17 17 17 17 23 17 17 17 17 17 25 3 3 3 3 3 3 3 3 3 3 3 3 3 3 13 3 3 13 3 3 13 15 15 15 6 15 15 5 5 3 3 3 3 3 3 3 3 3 13 3 3 3 3 3 13 3 3 13 3 3 3 3 13 3 3 13 3 3 3 13 3 3 3 3 24 17 17 17 17 17 17 17 17 17 17 17 17 17 17 17 17 17 17 17 17 17 17 17 17 
17 17 17 17 17 17 17 17 17 17 25 3 3 3 3 13 3 3 3 3 3 3 3 3 3 3 3 13 3 3 3 3 3 3 3 3 3 3 5 5 3 3 13 3 3 13 3 3 3 3 3 13 3 13 3 3 3 3 3 3 3 3 3 3 3 3 3 3 13 3 3 3 3 3 3 24 17 17 17 17 17 17 17 17 17 17 17 17 17 17 17 17 17 17 17 10 17 17 17 17 
17 17 17 17 17 17 17 17 17 17 25 3 3 3 3 3 3 3 3 3 3 3 3 3 3 13 3 3 13 3 3 13 3 13 3 3 3 3 5 5 3 3 3 3 3 3 3 3 6 13 3 3 3 3 3 13 3 13 3 4 4 4 4 4 4 4 13 3 3 3 3 3 3 13 3 18 22 22 22 22 22 22 22 22 22 22 22 22 22 22 22 17 17 17 17 17 17 17 17 17 
17 17 17 17 17 17 17 17 17 17 25 3 3 3 3 3 3 3 3 3 3 3 3 3 3 13 3 13 3 3 3 3 3 3 3 3 3 13 5 5 3 13 13 3 3 3 3 3 3 3 3 3 13 3 3 3 3 3 3 4 11 11 11 11 11 4 3 13 3 3 13 3 13 3 3 3 3 3 3 3 3 3 3 3 3 3 3 3 3 3 3 24 17 17 17 17 17 17 17 17 
17 17 17 17 17 17 17 17 17 17 25 3 3 13 3 3 3 3 3 3 3 3 3 3 3 3 3 13 13 3 3 3 13 3 3 3 3 3 5 5 3 3 6 3 3 13 3 13 3 3 13 3 3 3 13 3 3 13 3 4 11 11 11 11 11 4 3 3 3 3 3 3 3 3 13 3 3 3 3 3 3 13 3 3 13 3 3 3 3 13 3 24 17 17 17 17 17 23 17 17 
17 17 17 17 17 17 17 17 17 17 25 3 3 3 3 6 3 3 3 3 3 3 3 3 3 3 3 3 3 13 3 3 3 3 13 3 3 3 5 5 3 3 3 13 3 3 3 3 3 3 3 3 13 3 3 13 3 13 3 4 11 11 11 11 11 4 3 3 3 3 3 3 13 3 3 3 3 3 3 13 3 3 3 3 3 13 3 3 3 3 3 24 17 17 17 17 17 17 17 17 
17 17 23 17 17 17 17 17 17 17 25 3 3 3 3 3 3 3 3 3 3 3 3 3 3 13 3 13 3 13 3 3 3 3 6 3 3 3 5 5 3 3 3 3 3 3 3 3 3 3 13 3 3 3 3 3 3 3 3 4 11 11 11 11 11 4 3 3 13 3 13 3 3 3 3 3 13 3 3 3 3 3 3 3 3 3 3 13 3 3 3 24 17 17 17 17 17 17 17 17 
17 17 17 17 17 17 17 17 17 10 25 3 3 13 3 3 13 3 3 3 3 3 3 3 3 3 3 3 3 3 13 3 13 3 3 3 3 3 5 5 3 13 3 3 13 3 13 3 13 3 3 3 3 13 3 3 4 4 4 4 4 4 11 4 4 4 3 3 3 3 3 3 3 13 3 13 3 3 3 3 3 13 3 3 13 3 3 3 13 3 3 24 17 17 17 17 17 17 17 17 
17 17 17 17 17 17 17 17 17 17 25 3 3 3 3 3 3 3 3 3 3 3 3 3 13 3 3 3 3 3 3 13 3 3 3 3 3 3 5 5 3 3 3 3 3 3 3 3 3 3 3 13 3 3 3 3 4 11 11 11 11 11 11 11 11 4 3 3 13 3 13 3 3 3 3 3 3 3 3 13 3 3 3 3 3 3 13 3 3 3 3 24 17 17 17 17 17 17 17 17 
17 17 17 17 17 17 17 17 17 17 25 3 3 13 3 3 13 3 3 3 3 3 3 3 3 3 13 3 13 3 3 3 13 3 13 3 3 3 5 5 3 3 13 3 13 13 3 3 13 3 13 3 3 3 13 3 4 11 11 11 11 11 11 11 11 4 3 13 3 13 3 3 3 13 3 3 3 13 3 3 3 13 3 13 3 3 3 3 13 3 3 24 17 17 23 17 17 17 17 17 
17 17 17 17 17 17 17 17 17 17 25 3 3 3 6 3 3 3 3 3 3 3 3 13 3 3 13 3 3 3 13 13 3 13 3 3 3 3 5 5 3 3 3 3 3 3 13 3 3 3 3 3 3 3 3 3 4 11 11 11 11 11 11 11 11 4 3 3 3 3 3 13 3 3 3 3 3 3 3 3 3 3 3 3 13 3 3 3 3 3 3 24 17 17 17 17 10 17 17 17 
17 17 17 17 17 17 17 17 17 17 25 3 3 3 3 13 3 3 3 3 3 3 3 3 3 3 3 3 3 3 3 6 3 3 3 13 3 5 5 5 5 3 13 3 6 3 3 3 3 13 3 3 13 3 6 3 4 4 4 11 4 4 4 4 4 4 3 3 13 3 3 3 3 3 3 3 3 3 3 3 3 3 3 3 3 3 3 3 3 3 3 24 17 17 17 17 17 17 17 17 
17 17 17 17 17 17 17 17 17 17 25 3 3 3 3 3 3 3 3 3 3 3 3 3 5 5 5 5 5 5 5 5 5 5 5 5 5 5 5 5 5 5 5 5 5 5 5 5 5 5 5 5 5 5 5 5 5 5 5 5 5 5 5 5 5 5 5 5 5 5 5 5 5 5 5 5 5 5 5 5 5 5 5 5 5 3 3 13 13 3 3 24 17 17 17 17 17 17 17 17 
17 17 17 10 17 17 17 17 17 17 25 3 3 3 3 3 3 6 3 13 13 3 3 3 3 3 3 3 3 3 3 3 3 13 3 3 3 5 5 5 5 3 3 13 3 3 3 3 13 3 3 3 3 3 13 3 3 3 3 3 3 3 3 3 3 3 6 3 3 3 13 3 3 3 3 3 3 3 3 3 3 3 3 3 5 3 3 3 3 3 3 24 17 10 17 17 17 17 17 17 
17 17 17 17 17 17 17 17 17 17 25 3 3 13 13 3 3 3 3 3 3 3 3 13 3 3 3 3 3 3 13 3 3 3 3 3 3 3 5 5 3 3 3 3 3 3 13 3 3 3 13 3 13 3 3 3 13 3 3 3 3 3 3 3 3 3 3 3 13 3 3 3 3 3 3 3 3 3 3 3 3 3 13 3 5 3 3 3 3 3 3 24 17 17 17 17 17 17 17 17 
17 17 17 17 17 17 17 17 17 17 25 3 3 3 3 3 13 3 13 3 3 3 3 3 3 13 3 3 3 3 3 3 3 3 3 3 3 3 5 5 3 3 3 13 13 3 3 3 13 3 3 3 3 3 3 3 6 3 3 3 3 3 3 3 13 3 13 3 3 3 3 13 3 3 3 3 3 13 3 3 3 3 3 3 5 3 3 3 3 3 13 24 17 17 17 17 17 17 17 17 
17 17 17 17 17 17 17 17 17 17 25 3 3 3 3 3 3 3 3 3 3 13 3 3 3 3 3 3 3 3 13 13 3 13 3 13 3 3 5 5 3 13 3 3 3 3 3 3 3 3 13 3 3 13 3 3 3 3 3 3 3 3 3 6 3 3 3 13 3 3 3 3 3 3 3 3 13 3 3 13 3 3 3 3 5 13 13 3 3 3 3 24 17 17 17 17 17 17 17 17 
17 17 17 17 17 17 17 17 17 17 25 3 3 3 13 3 3 3 13 3 3 3 3 3 13 3 3 13 3 3 3 13 3 3 13 13 3 3 5 5 3 3 3 3 13 3 3 13 3 3 3 3 3 3 13 3 3 3 3 3 3 3 3 3 13 3 3 3 13 3 13 3 13 3 3 3 3 3 3 3 13 3 3 3 5 3 3 13 3 3 3 24 17 17 23 17 17 10 17 17 
17 17 17 17 17 17 23 17 17 17 25 3 3 3 3 3 3 3 3 3 3 3 3 3 3 3 3 3 13 3 13 3 3 13 3 3 3 3 5 5 3 3 3 3 3 3 3 3 13 3 3 13 3 13 3 3 3 3 3 3 3 3 3 13 3 3 13 3 13 3 3 3 3 13 3 3 3 3 3 3 3 3 3 3 5 3 3 3 3 3 3 24 17 17 17 17 17 17 17 17 
17 17 17 17 17 17 17 17 17 17 17 26 26 26 26 26 26 26 26 26 26 26 26 26 26 26 21 3 3 3 3 13 3 3 13 3 13 3 5 5 3 3 13 3 13 3 3 3 3 3 3 13 13 3 13 3 3 3 3 3 3 3 3 3 13 3 3 3 3 13 3 3 3 3 3 3 3 13 3 3 3 13 3 3 5 3 3 13 3 3 3 24 17 17 17 17 17 17 17 17 
17 17 17 17 17 17 17 17 17 17 17 17 17 17 17 17 17 17 17 17 17 17 17 17 17 17 25 13 3 13 3 3 13 3 13 3 3 3 5 5 3 3 3 3 3 13 3 13 3 3 13 3 3 13 3 3 3 3 3 3 3 3 3 13 3 13 3 3 13 3 3 3 3 3 3 3 13 3 3 3 3 3 3 3 5 3 3 3 3 3 3 24 17 17 17 17 17 17 17 17 
17 17 17 17 17 17 17 17 17 17 17 17 17 17 17 17 17 17 17 17 17 17 17 17 17 17 25 3 3 3 3 3 3 3 3 3 3 13 5 5 3 13 3 13 3 3 3 3 3 3 13 3 3 3 6 3 3 3 3 3 3 3 3 3 3 3 13 3 13 3 3 3 3 3 3 3 3 3 3 3 3 3 3 3 5 3 3 3 13 3 3 24 17 17 17 17 17 17 17 17 
17 17 17 17 17 17 17 17 17 17 17 17 17 17 17 17 17 17 17 17 17 17 17 17 17 17 25 3 13 3 4 4 4 4 4 4 4 3 5 5 3 3 3 3 3 13 13 3 3 13 3 3 13 3 3 3 3 3 3 3 3 3 3 3 3 6 13 3 3 13 3 3 13 3 3 3 3 13 3 3 13 3 3 3 5 3 3 3 3 3 3 24 17 17 17 17 17 17 17 17 
17 17 17 17 17 17 17 10 17 17 17 17 17 17 23 17 17 17 17 17 17 17 23 17 17 17 25 3 3 3 4 11 11 11 11 11 4 3 5 5 3 6 3 13 3 3 3 3 3 3 13 13 3 3 3 3 3 3 3 3 3 3 3 3 3 13 3 13 13 3 13 3 3 3 3 3 3 3 3 3 3 13 3 3 5 3 3 3 3 3 3 24 17 17 17 17 17 17 17 17 
17 17 17 17 17 17 17 17 17 17 17 17 17 17 17 17 17 17 17 17 17 17 17 17 17 17 25 13 3 3 4 11 11 11 11 11 4 3 5 5 3 3 13 3 3 3 13 3 13 3 3 13 3 13 3 3 3 3 3 3 3 6 3 3 3 13 3 13 3 3 3 3 3 3 3 13 3 3 3 3 3 3 3 3 5 3 13 3 13 3 3 24 17 10 17 17 17 17 17 17 
17 17 17 17 17 17 17 17 17 17 17 17 17 17 17 17 17 17 17 17 17 17 17 17 17 17 25 3 3 13 4 11 11 11 11 11 4 6 5 5 13 3 3 3 3 3 3 3 3 3 3 3 13 3 3 3 3 3 3 3 3 3 3 3 13 13 3 3 3 3 3 13 3 3 3 3 3 3 3 13 3 3 3 3 5 3 3 3 3 3 3 24 17 17 17 17 17 17 17 17 
17 17 17 17 17 17 17 17 17 17 17 17 17 17 17 17 17 17 17 17 17 17 17 17 17 17 25 3 3 3 4 11 11 11 11 11 4 3 5 5 3 3 3 13 3 3 3 3 3 3 13 3 3 13 3 3 3 3 3 3 3 3 3 3 3 13 3 3 13 3 3 3 3 3 3 3 3 3 3 3 3 3 3 3 5 3 3 3 3 3 13 24 17 17 17 17 17 17 17 17 
17 17 17 17 17 17 17 17 17 17 17 17 17 17 17 17 17 17 17 17 17 17 17 17 17 17 25 3 3 3 4 11 11 11 11 11 11 5 5 5 3 13 3 3 3 3 13 3 3 3 3 3 13 3 3 3 3 6 3 3 3 3 3 3 13 3 13 3 3 3 3 3 3 3 3 13 13 3 3 3 3 3 4 4 11 4 4 3 3 3 3 24 17 17 17 17 17 17 17 17 
17 17 17 17 17 17 17 17 17 17 17 17 17 17 17 17 17 17 17 17 17 17 17 17 17 17 25 3 13 3 4 11 11 11 11 11 4 3 5 5 3 13 3 3 3 3 3 3 13 3 13 3 3 13 13 3 3 3 3 3 3 3 3 13 13 3 3 3 3 3 13 3 3 3 3 3 3 13 13 3 3 4 11 11 11 11 11 4 3 3 13 24 17 17 17 17 17 17 17 17 
17 17 17 17 17 17 17 17 17 17 17 17 17 17 17 17 17 17 17 17 10 17 17 17 17 17 25 3 3 3 4 4 4 4 4 4 4 13 3 3 3 13 3 6 3 3 13 3 3 3 3 3 13 3 3 3 3 3 3 3 3 3 3 3 3 13 3 3 13 3 3 13 3 13 3 3 3 3 3 3 4 11 11 11 11 11 11 11 4 3 3 24 23 17 17 17 17 17 17 17 
17 17 17 17 17 17 17 17 17 17 17 17 17 23 17 17 17 17 17 17 17 17 17 17 17 17 25 13 3 13 3 3 3 3 3 13 3 3 3 3 3 3 3 3 3 3 3 3 3 3 13 3 3 13 3 3 3 3 3 3 3 6 3 13 3 3 13 3 3 3 3 3 3 3 3 13 3 3 3 3 4 11 11 11 11 11 11 11 4 3 3 24 17 17 17 17 17 17 17 17 
17 17 17 17 17 17 17 17 17 17 17 17 17 17 17 17 17 17 17 17 17 17 17 17 17 17 25 3 3 3 13 3 3 13 3 3 13 3 3 3 3 13 3 3 3 3 3 3 13 3 3 3 3 13 13 3 3 3 3 3 3 3 3 3 3 13 3 3 3 3 3 3 3 3 3 3 3 13 3 3 4 11 11 11 11 11 11 11 4 3 3 24 17 17 17 17 17 17 17 17 
17 17 17 17 17 17 17 17 17 17 17 17 17 17 17 17 17 17 17 17 17 17 17 17 17 17 25 3 13 3 3 13 3 3 3 3 3 13 3 13 3 3 3 3 13 3 13 3 3 13 3 3 13 3 3 13 3 3 3 3 3 3 3 3 13 3 13 13 3 13 13 13 3 3 3 13 13 3 3 3 4 11 11 11 11 11 11 11 4 13 3 24 17 17 17 17 17 17 17 17 
17 17 17 17 17 17 17 17 17 17 17 17 17 17 17 17 17 17 17 17 17 17 17 17 17 17 25 3 3 3 3 3 3 3 3 13 3 3 3 3 3 3 13 3 3 3 3 3 3 13 3 3 3 13 3 3 3 3 3 3 3 3 3 3 3 3 3 13 3 3 3 3 3 3 3 3 3 3 3 3 4 11 11 11 11 11 11 11 4 3 3 24 17 17 23 17 17 17 17 17 
17 17 17 17 17 17 17 17 17 17 17 17 17 17 17 17 17 17 17 17 17 17 23 17 17 17 25 3 3 3 13 3 3 13 3 3 13 3 13 3 13 3 3 3 3 3 3 3 3 3 13 3 13 3 3 6 3 3 3 3 3 3 3 3 3 13 3 13 3 3 3 3 3 13 3 3 3 13 3 3 3 4 4 4 4 4 4 4 3 3 3 24 17 17 17 17 17 17 17 17 
17 17 17 17 17 17 17 17 17 17 17 17 17 17 17 17 17 17 17 17 17 17 17 17 17 17 25 3 3 3 3 3 3 3 3 3 3 3 3 3 3 13 3 3 13 3 3 13 3 3 3 13 3 3 3 3 3 3 3 3 3 3 3 13 3 3 13 3 3 3 13 3 3 3 3 3 3 3 3 3 3 3 3 3 3 3 3 3 3 3 3 24 17 17 10 17 17 17 17 17 
17 17 17 17 17 17 17 17 17 17 17 17 17 17 17 17 17 17 17 17 17 17 17 17 17 17 25 3 3 13 3 3 13 3 3 13 3 3 3 3 3 3 3 3 3 3 3 3 3 3 3 3 13 3 3 13 3 3 3 3 3 6 3 3 3 13 3 3 13 3 3 3 3 3 3 3 3 3 3 3 3 13 3 3 3 13 3 3 13 3 13 24 17 17 17 17 17 17 17 17 
17 17 17 17 17 17 17 17 17 17 17 17 17 17 17 17 17 17 17 10 17 17 17 17 17 17 25 3 3 3 3 3 3 3 3 3 3 13 3 13 3 3 13 3 13 3 3 13 3 13 3 3 3 13 3 13 3 3 3 3 13 3 3 13 3 13 3 13 3 13 3 3 3 3 3 13 3 3 13 3 3 3 3 13 3 3 3 3 3 3 3 24 17 17 17 17 17 17 17 17 
17 17 17 17 17 17 17 17 17 17 17 17 17 17 17 17 17 17 17 17 17 17 17 17 17 17 25 3 3 3 13 3 3 3 3 3 3 3 3 3 3 3 3 3 3 3 3 3 3 3 3 3 3 3 13 3 13 3 3 3 13 3 13 3 3 13 3 3 3 3 3 3 3 3 3 3 3 3 3 3 3 3 3 3 3 3 3 13 3 3 3 24 17 17 17 17 17 17 17 17 
17 17 17 17 17 17 17 17 17 17 17 17 17 17 17 17 17 17 17 17 17 17 17 17 17 17 17 26 26 26 26 26 26 26 26 26 26 26 26 26 26 26 26 26 26 26 26 26 26 26 26 26 26 26 26 26 26 26 26 26 26 26 26 26 26 26 26 26 26 26 26 26 26 26 26 26 26 26 26 26 26 26 26 26 26 26 26 26 26 26 26 17 17 17 17 17 17 17 17 17 
17 17 17 17 17 17 17 17 17 17 17 17 17 17 17 17 17 17 17 17 17 17 17 17 17 17 17 17 17 17 17 17 17 17 17 17 17 17 17 17 17 17 17 17 17 17 17 17 17 17 17 17 23 17 17 17 17 23 10 17 17 23 17 17 17 17 17 17 17 17 17 17 17 17 17 17 17 17 17 17 17 17 17 17 17 17 17 17 17 17 17 17 23 17 17 17 17 17 17 17 
17 17 17 17 17 17 17 17 17 17 17 17 17 17 17 17 17 17 17 17 17 17 17 17 17 17 17 17 17 17 17 17 17 17 17 17 17 17 17 17 17 17 17 17 17 17 17 17 17 17 17 17 17 17 17 17 17 17 17 17 17 17 17 17 23 17 17 17 17 17 17 17 17 23 17 17 17 17 17 17 17 10 17 17 17 17 23 17 17 17 17 17 17 17 17 17 17 17 17 17 
17 17 17 17 17 17 17 17 17 17 17 17 17 17 17 17 17 17 17 17 17 17 17 17 23 17 17 17 17 17 17 17 17 17 17 17 23 17 17 17 17 17 17 17 17 17 17 17 17 23 17 17 17 17 17 17 17 17 23 17 17 17 17 17 17 17 17 17 17 17 23 17 17 17 17 17 17 17 17 17 17 17 17 17 17 17 17 17 17 17 17 17 17 17 17 17 17 17 17 17 
17 17 17 17 17 17 17 17 17 17 17 17 17 17 17 17 17 17 17 17 17 17 17 17 17 17 17 17 17 17 17 17 17 17 17 17 17 17 17 10 17 17 17 17 17 17 17 17 17 17 17 17 17 23 17 17 17 17 17 17 17 17 17 17 17 17 17 17 17 17 17 17 17 17 17 17 17 17 17 17 17 17 17 17 17 17 17 17 17 17 17 17 17 17 17 17 17 17 17 17 
17 17 17 17 17 17 17 17 17 17 17 17 17 17 17 17 17 17 17 17 17 17 17 17 17 17 17 17 17 17 17 17 17 17 17 17 17 17 17 17 17 17 17 17 17 17 17 17 17 17 17 17 17 17 17 17 17 17 17 17 17 17 17 17 17 17 17 17 17 17 17 17 17 17 17 17 17 17 17 17 17 17 17 17 17 17 17 17 17 17 17 17 17 17 17 17 17 17 17 17 
17 17 17 17 17 17 17 17 17 17 17 17 17 17 17 17 17 17 17 17 17 17 17 17 17 17 17 17 17 17 17 17 17 17 17 17 17 17 17 17 17 17 17 17 17 17 17 17 17 17 17 17 17 17 17 17 17 17 17 17 23 17 17 17 17 17 23 17 17 17 17 17 17 17 17 17 17 17 17 17 17 17 17 17 17 17 17 17 17 17 17 17 17 17 17 17 17 17 17 17 
17 17 17 17 17 17 17 17 17 17 17 17 17 17 17 17 17 17 17 17 17 17 17 17 17 17 17 17 17 17 17 17 17 17 17 17 17 17 17 17 17 17 17 17 17 17 17 17 17 17 17 17 17 17 17 23 17 17 17 17 17 17 17 17 17 17 17 17 17 17 17 17 17 17 17 17 17 17 17 17 17 17 17 17 17 17 17 17 17 17 17 17 17 17 17 17 17 17 17 17 
17 17 17 17 17 17 17 17 17 17 17 17 17 17 17 17 17 17 17 17 17 17 17 17 17 23 23 17 17 17 17 17 17 17 17 17 17 17 17 17 17 17 17 17 17 17 17 17 17 17 17 17 17 17 17 17 17 17 17 17 17 17 17 17 17 17 17 17 17 17 17 17 17 17 17 17 17 17 17 17 17 17 17 17 17 17 17 17 17 17 17 17 17 17 17 17 17 17 17 17 
17 17 17 17 17 17 17 17 17 17 17 17 17 17 17 17 17 17 17 17 17 17 17 17 17 17 17 17 17 17 17 17 17 17 17 17 17 17 17 17 17 17 17 17 17 17 17 17 17 17 17 17 17 17 17 17 17 17 17 17 17 17 17 17 17 17 17 17 17 17 17 17 17 17 17 17 17 17 17 17 17 17 17 17 17 17 17 17 17 17 17 17 17 17 17 17 17 17 17 17 
17 17 17 17 17 17 17 17 17 17 17 17 17 17 17 17 17 17 17 23 17 17 17 17 17 17 17 17 17 17 17 17 17 17 17 17 17 17 17 17 17 17 17 17 17 17 17 17 17 17 17 17 17 17 17 17 17 17 17 17 17 17 17 17 17 17 17 17 17 17 17 17 17 17 17 17 17 17 17 17 17 17 17 17 17 17 17 17 17 17 17 17 17 17 17 17 17 17 17 17 
17 17 17 17 17 17 17 17 17 17 17 17 17 17 17 17 17 17 17 17 17 17 17 17 17 17 17 17 17 17 17 17 17 17 17 17 17 17 17 17 17 17 17 17 17 17 17 17 17 17 17 17 17 17 17 17 17 17 17 17 17 17 17 17 17 17 17 17 17 17 17 17 17 17 17 17 17 17 17 17 17 17 17 17 17 17 17 17 17 17 17 17 17 17 17 17 17 17 17 17 
