2 2 2 2 2 2 2 2 2 2 2 2 2 2 2 2 2 2 2 2 2 2 2 2 2 2 2 2 2 2 2 2 2 2 2 2 2 2 2 2 2 2 2 2 2 2 2 2 2 2 2 2 2 2 2 2 2 2 2 2 2 2
2 2 2 2 2 2 2 2 2 2 2 2 2 2 2 2 2 2 2 2 2 2 2 22 2 2 2 2 2 2 2 2 2 22 2 2 2 2 2 2 2 2 2 2 2 2 2 2 2 2 2 2 2 2 2 2 2 2 2 2 2 2
2 2 2 22 2 2 2 2 2 2 2 2 22 2 2 2 2 2 2 2 2 2 2 2 2 2 2 2 2 2 2 2 2 2 2 2 2 2 2 2 2 2 2 2 2 22 2 2 2 2 2 2 2 2 2 2 2 2 23 2 2 2
2 2 2 2 2 2 2 22 2 2 2 2 2 2 2 2 2 22 2 2 2 2 2 2 2 2 23 2 2 22 2 2 2 2 2 2 2 2 2 2 22 2 2 2 2 2 2 2 2 2 2 2 2 2 2 2 2 22 2 2 2 2
2 2 2 2 2 2 2 2 2 2 2 2 2 2 2 2 2 2 2 2 2 2 2 2 2 2 2 2 2 2 2 2 2 2 2 2 2 2 2 2 2 2 2 2 2 2 2 2 2 2 2 2 2 2 2 2 2 2 2 2 2 2
2 2 2 2 2 2 2 2 15 15 15 15 15 15 15 15 15 15 15 15 15 15 15 15 15 15 15 15 15 15 15 15 15 15 15 15 15 15 15 15 15 15 15 15 15 15 15 15 15 15 15 15 2 2 2 2 2 2 2 2 2
2 2 2 2 22 2 2 14 0 3 3 3 3 0 0 20 0 0 20 0 0 0 20 0 20 0 0 0 0 0 0 0 0 0 20 0 0 0 0 0 0 0 0 20 0 0 0 20 0 0 0 0 13 2 2 2 2 2 2 2 2 2
2 2 2 2 2 2 2 14 0 0 3 3 3 20 0 0 20 0 0 20 0 20 0 20 0 0 20 0 20 0 0 20 20 20 0 0 0 20 0 0 0 20 0 0 0 20 0 20 0 0 0 0 13 2 2 2 22 2 2 2 2 2
2 2 2 2 2 2 2 14 0 3 0 3 0 3 3 3 3 3 0 0 3 3 0 20 0 4 0 20 20 0 3 3 3 3 3 3 3 3 3 0 0 20 0 21 0 0 0 3 3 0 0 0 13 2 2 2 2 2 2 2 2 2
2 2 22 2 2 2 2 14 0 0 3 3 0 3 0 0 0 0 0 0 3 3 3 0 0 4 0 3 3 3 3 3 3 3 21 3 3 3 3 3 3 3 0 20 0 0 0 0 3 3 0 0 13 2 2 2 2 2 2 2 22 2
2 2 2 2 2 2 2 14 0 0 3 0 3 3 0 0 0 0 0 0 3 3 3 3 0 4 0 3 3 3 3 3 3 3 3 3 10 16 12 18 0 20 0 20 0 0 3 3 3 0 20 0 13 2 2 2 2 2 2 2 2 2
2 2 2 2 2 2 2 14 0 3 0 3 0 0 0 0 0 0 0 0 3 0 0 3 0 4 0 3 3 0 3 21 3 0 3 8 6 9 13 2 18 0 0 0 0 21 0 0 0 3 0 0 13 2 2 2 2 2 2 2 2 2
2 2 2 2 2 2 2 14 0 3 3 3 3 3 3 3 3 3 3 3 3 3 3 3 0 4 0 3 3 3 3 3 3 3 3 6 6 6 13 2 2 18 0 0 20 0 0 0 0 3 0 20 13 2 2 2 2 2 2 2 22 2
2 2 2 2 2 22 2 14 0 0 3 3 3 0 0 0 0 20 20 20 20 0 0 21 0 4 0 20 0 20 20 20 20 20 20 6 7 6 13 2 2 2 18 0 20 0 0 0 3 3 0 0 13 2 2 2 2 2 2 2 2 2
2 2 2 2 2 2 2 14 0 3 3 3 3 0 4 4 4 4 4 4 4 4 4 4 4 4 4 4 4 4 4 4 4 4 4 4 5 5 5 5 2 2 2 14 3 3 3 3 3 3 0 0 13 2 2 2 2 2 2 2 2 2
2 2 2 2 2 2 2 14 0 0 3 3 3 0 4 0 20 0 20 0 0 20 0 20 0 20 0 20 4 20 20 0 21 20 0 20 20 17 2 2 2 2 14 21 0 20 0 0 0 0 0 0 13 2 2 2 2 2 2 2 2 2
2 2 22 2 2 2 2 14 0 0 0 3 3 3 4 3 3 3 3 3 3 3 3 3 3 3 3 0 4 20 3 3 3 3 3 3 3 3 17 2 2 2 19 0 3 0 3 3 3 0 0 0 13 2 2 2 2 2 2 2 2 2
2 2 2 2 2 2 2 14 0 0 3 3 3 3 4 3 3 21 0 3 3 3 0 3 3 3 3 3 4 3 3 0 3 20 3 0 0 3 3 17 15 19 0 3 0 0 20 0 3 0 0 0 13 2 2 2 2 2 2 22 2 2
2 2 2 2 2 2 2 14 0 3 3 3 3 3 4 3 3 0 3 3 0 3 3 3 0 3 3 3 4 3 0 3 0 3 20 3 3 0 3 3 3 0 3 0 0 0 20 20 0 20 20 0 13 2 2 22 2 2 2 2 2 2
2 2 2 2 2 2 2 14 0 3 3 3 3 1 4 1 3 3 0 3 0 3 3 0 3 3 3 3 4 3 3 3 3 3 0 3 3 0 0 3 3 0 3 0 0 0 20 20 0 0 20 0 13 2 2 2 2 2 2 2 2 2
2 2 2 2 22 2 2 14 0 3 3 3 1 11 11 11 1 3 3 3 0 3 3 3 3 3 3 3 4 3 3 3 20 20 3 0 3 0 0 3 3 3 0 21 0 0 20 0 0 3 3 3 13 2 2 2 22 2 2 2 2 2
2 2 2 2 2 2 2 14 0 0 3 3 1 11 11 11 1 3 0 3 0 3 3 3 3 3 0 0 4 0 0 3 3 0 3 3 0 3 3 0 3 0 3 0 20 0 3 3 3 0 3 3 13 2 2 2 2 2 2 2 2 2
2 2 2 2 2 2 2 14 0 0 0 3 1 11 11 11 1 3 3 3 0 3 3 3 0 0 20 0 4 0 20 0 0 3 0 3 3 0 3 0 3 0 3 3 20 0 0 0 3 3 0 3 13 2 2 2 2 2 2 2 2 2
2 2 2 22 2 2 2 14 0 0 3 3 1 11 11 11 1 3 3 0 3 0 0 3 0 20 20 4 4 4 0 20 0 3 3 3 0 3 0 3 3 3 0 3 3 0 20 0 0 3 3 3 13 2 2 2 2 2 2 2 2 2
2 2 2 2 2 2 2 14 0 0 3 3 1 11 11 11 1 3 0 3 3 0 3 3 0 20 0 4 4 4 0 21 0 3 3 0 3 3 3 0 3 0 3 3 3 3 0 0 3 3 3 3 13 2 2 2 2 2 2 2 2 2
2 2 2 2 2 2 2 14 0 3 3 3 1 11 11 11 1 3 3 0 3 3 0 3 0 21 0 4 4 4 20 0 0 3 0 3 3 0 3 3 0 3 3 0 3 3 3 0 3 3 0 3 13 2 2 2 2 2 2 2 2 2
2 2 2 2 2 2 2 14 0 3 3 3 1 11 33 11 1 3 0 3 0 3 0 3 0 0 20 0 4 0 20 20 21 3 3 3 3 0 3 0 3 3 0 3 0 3 0 3 0 3 3 3 13 2 2 2 2 2 2 2 2 2
2 2 2 2 2 22 2 14 0 3 3 3 1 11 11 11 1 3 3 3 0 3 3 3 3 3 0 20 4 20 0 3 3 3 3 0 3 3 3 3 3 0 3 3 3 3 0 3 0 3 3 3 13 2 2 2 2 22 2 2 2 2
2 2 2 2 2 2 2 14 0 3 3 3 1 1 1 1 1 3 3 3 3 3 3 3 3 3 3 0 4 0 3 3 3 3 3 3 3 3 3 3 3 3 3 3 3 3 3 3 3 3 3 0 13 2 2 2 2 2 2 2 2 2
2 2 2 2 2 2 2 14 0 3 3 3 3 3 3 3 3 3 3 3 3 3 3 3 3 3 3 3 4 3 3 3 3 3 3 3 3 3 3 3 3 3 3 3 3 3 3 3 3 3 3 0 13 2 2 2 2 2 2 2 2 2
2 2 2 2 2 2 2 14 0 3 3 3 3 3 3 3 3 3 3 3 3 3 3 3 3 3 3 3 4 3 3 3 3 3 3 3 3 3 3 3 3 3 3 3 3 3 3 3 3 3 3 0 13 2 2 2 2 2 2 2 2 2
2 2 2 2 2 2 2 14 0 3 3 3 3 3 3 3 3 3 3 3 3 3 3 3 3 3 3 3 4 3 3 3 3 3 3 3 3 3 3 3 3 3 3 3 3 3 3 3 3 3 3 0 13 2 2 2 2 2 2 2 2 2
2 2 2 2 2 2 2 14 0 3 3 3 3 3 3 3 3 3 3 3 3 3 3 3 3 3 3 3 4 3 3 3 3 3 3 3 3 3 3 3 3 3 3 3 3 3 3 3 3 3 3 0 13 2 2 2 2 2 22 2 2 2
2 2 2 2 2 2 2 14 0 3 3 3 3 3 3 3 3 3 3 3 3 3 3 3 3 3 3 3 4 3 3 3 3 3 3 3 3 3 3 3 3 3 3 3 3 3 3 3 3 3 3 0 13 2 2 2 2 2 2 2 2 2
2 2 2 2 22 2 2 14 0 3 3 3 3 3 3 3 3 3 3 3 3 3 3 3 3 3 3 3 4 3 3 3 3 3 3 3 3 3 3 3 3 3 3 3 3 3 3 3 3 3 3 0 13 2 2 2 2 2 2 2 2 2
2 2 2 2 2 2 2 14 0 3 3 3 3 3 3 3 3 3 3 3 3 3 3 3 3 3 0 0 4 20 0 3 3 3 3 3 3 3 3 3 3 3 3 3 3 3 3 3 3 3 3 0 13 2 2 22 2 2 2 2 2 2
2 2 2 2 2 2 2 14 0 3 3 3 3 3 3 3 3 3 3 3 3 3 3 3 3 3 0 20 0 0 21 3 3 3 3 3 3 3 3 3 3 3 3 3 3 3 3 3 3 3 3 0 13 2 2 2 2 2 2 2 2 2
2 2 2 2 2 2 2 14 0 3 3 3 3 3 3 3 3 3 3 3 3 3 3 3 3 3 3 0 0 20 3 3 3 3 3 3 3 3 3 3 3 3 3 3 3 3 3 3 3 3 3 0 13 2 2 2 2 2 2 2 2 2
2 2 2 2 2 2 2 14 0 3 3 3 3 3 3 3 3 3 3 3 3 3 3 3 3 3 3 3 3 3 3 3 3 3 3 3 3 3 3 3 3 3 3 3 3 3 3 3 3 3 3 0 13 2 2 2 2 2 2 2 2 2
2 2 2 2 2 2 2 14 0 3 3 3 3 3 3 3 3 3 3 3 3 3 3 3 3 3 3 3 3 3 3 3 3 3 3 3 3 3 3 3 3 3 3 3 3 3 3 3 3 3 3 0 13 2 2 2 22 2 2 2 2 2
2 2 2 2 2 2 2 14 0 3 3 3 3 3 3 3 3 3 3 3 3 3 3 3 3 3 3 3 3 3 3 3 3 3 3 3 3 3 3 3 3 3 3 3 3 3 3 3 3 3 3 0 13 2 2 2 2 2 2 2 2 2
2 2 22 2 2 2 2 14 0 3 3 3 3 3 3 3 3 3 3 3 3 3 3 3 3 3 3 3 3 3 3 3 3 3 3 3 3 3 3 3 3 3 3 3 3 3 3 3 3 3 3 0 13 2 2 2 23 2 2 2 2 2
2 2 2 2 2 2 2 14 0 3 3 3 3 3 3 3 3 3 3 3 3 3 3 3 3 3 3 3 3 3 3 3 3 3 3 3 3 3 3 3 3 3 3 3 3 3 3 3 3 3 3 0 13 2 2 2 2 2 2 2 2 2
2 2 2 2 2 2 2 14 0 3 3 3 3 3 3 3 3 3 3 3 3 3 3 3 3 3 3 3 3 3 3 3 3 3 3 3 3 3 3 3 3 3 3 3 3 3 3 3 3 3 3 0 13 2 2 2 2 2 22 2 2 2
2 2 2 2 2 2 2 14 0 3 3 3 3 3 3 3 3 3 3 3 3 3 3 3 3 3 3 3 3 3 3 3 3 3 3 3 3 3 3 3 3 3 3 3 3 3 3 3 3 3 3 0 13 2 2 2 2 2 2 2 2 2
2 2 2 2 2 2 2 14 0 3 3 3 3 3 3 3 3 3 3 3 3 3 3 3 3 3 3 3 3 3 3 3 3 3 3 3 3 3 3 3 3 3 3 3 3 3 3 3 3 3 3 0 13 2 2 2 2 2 2 2 2 2
2 2 2 2 2 2 2 14 0 3 3 3 3 3 3 3 3 3 3 3 3 3 3 3 3 3 3 3 3 3 3 3 3 3 3 3 3 3 3 3 3 3 3 3 3 3 3 3 3 3 3 0 13 2 2 2 2 2 2 2 2 2
2 2 2 2 2 2 2 14 0 3 3 3 3 3 3 3 3 3 3 3 3 3 3 3 3 3 3 3 3 3 3 3 3 3 3 3 3 3 3 3 3 3 3 3 3 3 3 3 3 3 3 0 13 2 2 2 22 2 2 2 2 2
2 2 2 2 2 2 2 14 0 3 3 3 3 3 3 3 3 3 3 3 3 3 3 3 3 3 3 3 3 3 3 3 3 3 3 3 3 3 3 3 3 3 3 3 3 3 3 3 3 3 3 0 13 2 2 2 2 2 2 2 2 2
2 2 2 2 2 2 2 14 0 0 0 0 0 0 0 0 0 0 0 0 0 0 0 0 0 0 0 0 0 0 0 0 0 0 0 0 0 0 0 0 0 0 0 0 0 0 0 0 0 0 0 0 13 2 2 2 2 2 2 2 2 2
2 2 22 2 2 2 2 2 12 12 12 12 12 12 12 12 12 12 12 12 12 12 12 12 12 12 12 12 12 12 12 12 12 12 12 12 12 12 12 12 12 12 12 12 12 12 12 12 12 12 12 12 2 2 2 2 2 2 2 2 2 2
2 2 2 2 2 2 2 2 2 2 2 2 2 2 2 2 2 2 2 2 2 2 2 2 2 2 2 2 2 2 2 2 2 2 2 2 2 2 2 2 2 2 2 2 2 2 2 2 2 2 2 2 2 2 2 2 2 2 22 2 2 2
2 2 2 2 2 2 2 2 2 2 2 2 2 2 2 22 2 2 2 2 2 2 2 2 2 23 2 2 2 2 2 2 2 2 2 2 2 2 22 2 2 2 2 2 2 2 2 2 22 2 2 2 2 2 2 2 2 2 2 2 2 2
2 2 2 2 22 2 2 2 2 2 2 2 2 2 2 2 2 2 2 2 2 2 2 2 2 2 2 2 2 2 22 2 2 2 2 2 2 2 2 2 2 2 2 2 2 2 2 2 2 2 2 2 2 2 2 2 2 2 2 2 2 2
2 2 2 2 2 2 2 2 2 2 2 2 2 2 2 2 2 2 2 2 2 22 2 2 2 2 2 2 2 2 2 2 2 2 2 2 2 2 2 2 2 2 2 2 22 2 2 2 2 2 2 2 2 2 2 2 2 2 2 2 2 2
2 2 2 2 2 2 2 2 2 2 2 2 2 2 2 2 2 2 2 2 2 2 2 2 2 2 2 2 2 2 2 2 2 2 2 2 2 2 2 2 2 2 2 2 2 2 2 2 2 2 2 2 2 2 2 2 2 2 2 2 2 2